Date, Description, Withdrawals, Deposits, Balance
1 Jan, Opening Balance, , , 2171.87
3 Jan, Rent, 650.00, , 1521.87
6 Jan, Payroll Deposit, , 142.28, 1664.15
13 Jan, Payroll Deposit, , 173.34, 1837.49
19 Jan, e-Transfer sent, 210.00, , 1627.49
20 Jan, Payroll Deposit, ,91.61, 1719.10
23 Jan, e-Transfer sent, 20.00, , 1699.10
23 Jan, e-Transfer sent, 68.94, , 1630.16
27 Jan, Payroll Deposit, , 219.01, 1849.17
27 Jan, Closing Balance, , , 1849.17