,Date,Head Category,Category,Amount,Account,Account Balance
0,2023-01-03,Housing,Rent,-650,1,1521.87
1,2023-01-06,Income,Salary,142.28,1,1664.15
2,2023-01-13,Income,Salary,173.34,1,1837.49
4,2023-01-19,Miscellaneous,e-Transfer sent,-210,1,1627.49
5,2023-01-20,Income,Salary,91.61,1,1719.1
6,2023-01-23,Miscellaneous,e-Transfer sent,-20,1,1699.1
7,2023-01-23,Miscellaneous,e-Transfer sent,-68.94,1,1630.16
8,2023-01-27,Income,Salary,219.01,1,1849.17
